#####
#...#
#...#
##.##
#...#
#####

\robot 1 3
\robot 3 3
\robot 2 2