#....#
#..#.#
####.#
#....#
#.####
#.####

\robot 4 2
\robot 4 3
\robot 4 4