#.........
#..#..###.
....##....
#...#..#..
.........#
#...##....
........##
.#.###....
.#.###..##
..........