..##.....#...#.#...
..#.###......#...#.
.....#...........##
###......##########
...................
..#...........###..
.....###..###......
..#.##...###...###.
...................
.#..##....#.###...#
#########..........
..##.######...##...
...................
......#.....#......
.######..........##
.#############.....
...................
####...........####
......####.........